下痢便	下痢症
泥状便	下痢症
下痢症状	下痢症
水様性下痢	下痢症
ＣＤ関連腸炎	偽膜性大腸炎
下痢傾向	下痢症
ＭＲＳＡ菌血症	ＭＲＳＡ感染症
溶連菌感染	溶連菌感染症
敗血性ショック	敗血症性ショック
活動性結核	結核
肺浸潤	肺結核
緑膿菌感染	緑膿菌感染症
胃腸炎症状	胃腸炎
抗酸菌感染症	非結核性抗酸菌症
敗血症ショック	敗血症性ショック
結核感染	結核
嫌気性菌	嫌気性菌感染
ブドウ球菌	ぶどう球菌感染症
ＭＲＳＡ感染	ＭＲＳＡ感染症
肺ＮＴＭ症	肺非結核性抗酸菌症
梅毒感染	梅毒
肺非定型抗酸菌症	肺非結核性抗酸菌症
重症敗血症	敗血症
インフルエンザ桿菌	インフルエンザ菌感染症
腸管感染	感染性腸炎
リンパ節結核	結核性リンパ節炎
ＭＲＳＡ	ＭＲＳＡ感染症
ＨＰ感染	ヘリコバクター・ピロリ感染症
ノカルジア肺炎	肺ノカルジア症
結核性関節炎	関節結核
日和見感染症	日和見感染
重症細菌感染症	細菌感染症
水様下痢便	下痢症
結核性心膜炎	心膜結核
肺結核症	肺結核
水溶性下痢	下痢症
壊死性遊走性紅斑	遊走性紅斑
リステリア菌血症	リステリア性敗血症
アメーバ腸炎	アメーバ赤痢
マイコプラズマ感染	マイコプラズマ感染症
硬結性紅斑	結核性硬結性紅斑
髄膜炎菌	髄膜炎菌感染症
肺外結核	結核
非結核性肺抗酸菌症	肺非結核性抗酸菌症
インフルエンザウイルス感染症	インフルエンザ菌感染症
結核性縦隔リンパ節炎	結核性リンパ節炎
結核病変	結核
ＭＳＳＡ	ＭＲＳＡ感染症
アメーバ肝膿瘍	肝アメーバ症
ツツガムシ病	つつが虫病
ヤコブ病	クロイツフェルト・ヤコブ病
頸部リンパ節結核	頚部リンパ節結核
ＭＳＳＡ敗血症	黄色ぶどう球菌敗血症
劇症型溶血性レンサ球菌感染症	溶連菌感染症
放線菌感染	放線菌症
感染性ショック	細菌性ショック
結核性病変	結核
インフルエンザウイルス感染	インフルエンザ菌感染症
ノカルジア感染症	ノカルジア症
肺炎球菌感染	肺炎球菌感染症
肺空洞病変	結核性空洞
黄色ブドウ球菌菌血症	ぶどう球菌感染症
細菌性敗血症	敗血症
クロイツフェルトヤコブ病	クロイツフェルト・ヤコブ病
ノカルジア感染	ノカルジア症
アメーバ性大腸炎	アメーバ赤痢
結核性髄膜脳炎	脳脊髄膜結核
ＣＪＤ	クロイツフェルト・ヤコブ病
レジオネラ感染	レジオネラ症
細菌性赤痢	赤痢
重症腸炎	腸炎
急性胃腸炎症状	急性胃腸炎
レジオネラ感染症	レジオネラ症
波状熱	ブルセラ症
脊椎カリエス	脊椎結核
ＰＭＬ	進行性多巣性白質脳症
メチシリン耐性黄色ブドウ球菌	ＭＲＳＡ感染症
サルモネラ感染	サルモネラ感染症
黄色ブドウ球菌感染	ぶどう球菌感染症
結核性肉芽腫	結節性肺結核
ランブル鞭毛虫症	ジアルジア症
アメーバ大腸炎	アメーバ赤痢
尿路性敗血症	敗血症
結核性胸腹膜炎	結核性胸膜炎
結核菌感染症	結核
リケッチア症	リケッチア感染症
大腸炎症状	大腸炎
リケッチア感染	リケッチア感染症
アメーバ性腸炎	アメーバ赤痢
結核性膝関節炎	結核性滑膜炎
播種性非結核性抗酸菌症	非結核性抗酸菌症
急性出血性腸炎	出血性腸炎
黄色ブドウ球菌敗血症	黄色ぶどう球菌敗血症
トキシックショック症候群	毒素ショック症候群
梅毒性視神経炎	晩期梅毒性球後視神経炎
膠原線維性大腸炎	大腸炎
肺炎球菌敗血症	肺炎球菌性敗血症
赤痢アメーバ症	アメーバ症
肺ノカルジア感染症	肺ノカルジア症
播種性非定型抗酸菌症	非結核性抗酸菌症
